
# common config for a user

- leadsto

 	# Define arrow causal directions ... left to right
 	# what does A -----> B mean, and what is its opposite?

        + leads to (lt) - arriving from (af)

 	# causal order, preconditions, succession

 	+ forwards (fwd) - backwards (bwd)              # A (forwards)	B,  B (backwards) A
 	+ affects  (aff)  - affected by (baff)  	# A (affects) 	B,  B (affected by) A
 	+ causes   (cf)  - is caused by (cb)
 	+ used for (for)  - is a possible use of (useof)
 	+ generates (cf)  - is generated by (gen)
 	+ determines (det)  - is determined by (detby)
 	+ leads to (to)  - comes from (fr)
        + is followed by (next) - is preceded by (prev)    
        + then the next is (then) - previous (prior)

        // Flow charts / FSMs etc

	+ next if yes (ifyes) - is a positive outcome of (bifyes)
	+ next if no (if no)  - is anegitive outcome of (bifno)

        + intends (intt)    - is the intent of (iof)
        + proposed (prop)    - proposed by (propby)
        + decided (decide)    - decided by (decidby)
        + spoke to (spoke)    - was spoken to by (talked)

        + implements (impl) - was implemented by (implorg)        
        + named after (named) - inspired the name (inspname)

 	# these next two are mutually complementary interpretations
 	+ succeeded by (succ) - preceded by (pre)
 	+ comes before (bfr)  - comes after (aft)

 	# these translations are causal transformations, not just properties.
 	# they have transitive meaning

 	# if we insist on using + or - in the name, then quote it

 	+ "positive (+)" (+) - "negative (-)" (-)

        # More examples to play with, semantics are always reversible

 	+ gives or results in (gives) - is a result of (result of)
 	+ depends on (dep) - drives (drv)
 	+ influences (infl) - is influenced by (isinfl)
        + signals to (signals) - is signalled by (sigby)
        + supports (support) - is supported by (suportby)

        + wrote (wrote) - written by (written)
        + invented (invent) - invented by (inventby)

        # Numbers can be interpreted either as set order (value) 
        # or by set containment (count), so be careful with semantics!

        # succeeds is more accurate in terms of order
        #
	# + is less than (lth) - is greater than (gth)

 :: construction, building, industry ::

     + supplies (supply) - is supplied by (supplyby)
     + delivered to (delivaddr) - delivery address for (delivgoods)

     + handles (handles) - is handled by (handleyby)      // has dual meanings!
     + coordinates (coord) - is coordinated by (coordby)

 :: chinese language ::

 	+ english for pinyin (ep) - pinyin for english (pe)  
 	+ pinyin for hanzi (ph) - hanzi for pinyin (hp)
 	+ hanzi for english (he) - english for hanzi (eh)
 	+ english for Norwegian (en) - Norwegian for english (ne)
 	+ english to norsk (en) - norsk to english (ne)

 :: wardley maps ::

      + matures into  (mature)   - is a maturation of (matured)
      + develops into (dev)      - is a development of (devfrom)

#########################################################

- contains

 + has component (has) - is component of (part)
 + contains (c)        - is within (in)
 + is a set of (setof) - is part of set (inset) // designations can be multi-valued
 + contains (cont)     - is an element of (el)
 + subsumes (sub)      - is subsumed by (subby)
 + swallows (sw)       - is swallowed by (swby)
 + consists of (cons)  - is part of (pt)
 + makes use of (uses) - occurs in (occurs)
 + has aspect (aspect) - is an aspect of (aspect of)
 + has key issue (key issue) - is a key issue of (is key)
 + generalizes (general) - is a special case of (special)
 + includes (includes) - is a kind of of (kind of)
 + has example (hasex) - example of (ex)
 + has member (memb) - belongs to (belong)

 + has friend (fr) - is considered a friend of (isfrof)
 + discusses (disc) - is discussed in (isdisc)
 + obeys the rule (rule) - is a rule for (rule4)

 + owns (owns) - is owned by (ownby)
 + rents (rents) - is rented by (rentby)

 + occurs in the context of (occurs in)  - is a possible context for (ctxfor)

 + employer of (employs) - is employed at (workat)

 + based in (org) - is the home of (home)

 + right word? (word?) - right usage? (usage?)

 :: cluedo ::

 + happened while (activity) - happened during (during)
 + employs method (how)  - is a method for (method)

#########################################################

- properties

 # properties are more type-centric in a logical sense
 # because they are ontological

 #  A (expresses) B, B (is expressed by) A

 + has resource/reference  (resource) - is a resource for (isresource)
 + NOT correct about (wrongabt) - is NOT a case of (wrong)
 + expresses (expr)          - is expressed by  (exprby)
 + has property (prop)       - is a property of (propof)
 + means (means)             - is meant by (meansb)
 + is pronounced as (pronas) - is the pronunciation for (pronof)
 + is short for (short for)  - can be shortened to (shorter)
 + has friend (friend) - is a friend of (isfriend)

 # Here we see type classifiers in action

 + is called (called) - name of (pname)

 + may have state (instate) - is a possible state of (stateof)
 + may have value (hasX)    - is a possible value for (isX)

 + note/remark (note) - is a note or remark about (isnotefor)
 + added remark (remark) - is a remark concerning (concerns)
 + please note! (NB) - is an important remark concerning (important regarding)

 + stands for (sfor)  - is a case of (case of)
 + refers to (ref)    - may be referred to as (refas)
 + has role (role)    - is the role of (isrole)
 + has employment status (emplstatus) - employment status of (emplstatof)

 + has the structure of (hasstruct) - structure found in (structex)

 + likes (lk) - is liked by (lkby)

 :: delivery ::

 + is in condition (condition) - condition of (condof)

 :: cluedo ::

 + involved the use of (with) - item is implicated in  (invwith)
 + during activity (while) - activity taking place at (takeplace)
 + at location (where) - location involved in (location of)
 + perpetrated by (perpby) - perpetrator of (perp)
 + victim was (victim) - has the role of victim in (victimof)

 + happened while (while) - was taking place when (during)
 + could be used in the role of (could be) - could be fulfilled by (fulfilled by)

 + is about about the subject (about) - is the subject of (hassubject)

#########################################################

- similarity # nearness, proximity

 looks like         	(ll)
 sounds like        	(sl)

 equals             	(eq)
 same as                (=)
 is not the same as 	(!eq)
 is not                 (not)

 similar to         	(sim)
 associated with    	(ass)  # (loose coupling)
 see also               (see)
 near               	(nr)

 met with               (met) // a mutual coincidence

 comes together with    (and)
 connects to            (connects)
 is adjacent with       (adj)

 :: wardley maps ::

  approximates    (approx)

#########################################################

 - annotations

 // for marking up a text body: body (relation) annotation
 // hyphen is illegal, as it's common in text and ambiguous to section grammar

 + (discusses)
 = (depends on)
 * (is a special case of)
 # - (explains) , this is illegal
 > (hassubject)











